########
#ABCDEF#
#GHIJKL#
#MNOPQR#
#STUVWX#
###YZ###